1111111111
1P11C000C1
10C1101001
10000011E1
1111111111