1111111111
1P110001C1
1001101011
10000011E1
1111111111