1111111111
1P110000C1
1001101011
10000011E1
1110010001
1C10000C11
1000011111
1111111111
